1 1 1 1 1 1 1 1 1 1 1 1 1 1 1 1 1 1 1 1 1 1 1 1 1 1 1 1 1 1 1 1 1 1 1 1 1 1 1 1 1 1 1 1 1 1 1 1 1 1
1 0 0 3 0 0 3 0 0 0 0 3 3 3 3 3 0 0 0 3 3 0 0 0 3 0 0 0 0 0 0 0 0 0 0 0 11 4 4 12 0 0 0 0 0 0 0 0 0 1
1 0 0 3 0 0 0 0 0 0 0 3 3 3 3 0 0 0 0 3 3 0 0 0 0 0 0 0 0 0 0 0 0 0 0 11 14 2 15 10 0 0 0 0 0 0 0 0 0 1
1 0 0 0 3 0 0 0 0 0 0 0 3 3 0 0 0 0 0 3 3 0 0 0 0 0 0 0 0 0 0 0 0 0 11 14 2 15 10 0 0 0 0 0 0 0 0 0 0 1
1 0 0 0 0 3 0 0 0 3 0 0 3 3 0 0 0 0 3 3 3 3 0 0 0 0 0 0 0 0 0 0 0 11 14 2 2 8 0 0 0 0 0 3 3 3 3 3 0 1
1 0 0 0 3 3 3 0 0 0 3 0 3 0 0 0 0 3 3 3 3 3 3 0 0 0 0 0 0 0 0 0 11 14 2 2 15 10 0 0 0 0 0 3 0 0 0 3 0 1
1 0 0 3 3 0 0 3 0 0 0 0 3 0 0 0 0 3 3 3 3 3 3 0 0 0 0 0 0 0 0 11 14 2 15 13 10 0 0 0 0 0 0 3 0 0 0 3 0 1
1 0 0 0 0 0 0 0 3 0 0 0 3 0 0 0 0 1 1 1 1 1 1 0 0 0 0 0 0 0 0 7 2 2 8 0 0 0 0 0 0 0 0 3 0 0 0 3 0 1
1 0 0 0 0 0 0 0 0 0 0 0 3 3 0 0 0 1 5 5 5 5 1 0 0 0 0 0 0 0 11 14 2 15 10 0 0 3 3 3 3 3 3 3 0 0 0 3 0 1
1 0 0 0 0 3 3 3 3 3 3 3 3 3 0 0 0 1 5 5 5 5 1 0 0 0 0 11 4 4 14 2 15 10 0 0 0 3 3 3 0 0 0 0 0 0 0 3 0 1
1 0 0 0 3 3 3 3 3 3 3 3 3 3 0 0 0 1 5 5 5 5 1 0 0 0 0 7 2 2 2 2 8 0 0 0 0 0 3 0 0 0 0 0 0 0 0 3 0 1
1 0 0 0 0 3 3 3 3 11 4 12 3 3 0 0 0 1 1 3 1 1 1 0 0 0 0 7 2 2 2 15 10 0 0 0 0 0 3 0 0 0 0 0 3 3 3 3 0 1
1 0 0 0 0 0 0 3 3 7 6 8 3 3 0 0 0 0 0 3 0 0 0 0 0 0 0 7 2 2 15 10 0 0 0 0 0 0 3 0 0 0 0 0 3 0 0 0 0 1
1 0 0 0 0 0 0 3 3 9 13 10 3 3 0 0 0 0 0 3 0 0 0 0 0 0 11 13 13 13 10 0 0 0 0 0 0 3 3 0 0 0 0 3 3 3 0 0 0 1
1 0 0 0 3 0 3 3 3 3 3 3 3 3 3 0 0 0 0 3 0 0 0 0 0 0 0 0 0 0 0 0 0 0 3 3 3 3 0 0 0 0 0 3 3 3 0 0 0 1
1 0 0 0 3 3 18 3 3 3 3 3 3 3 3 0 0 0 0 3 3 3 3 3 3 3 3 3 3 3 3 3 3 3 3 0 0 3 0 0 0 0 0 0 0 0 0 0 0 1
1 0 0 0 0 3 3 3 0 0 0 0 0 3 3 0 0 0 0 3 0 0 0 0 0 0 0 0 0 0 0 0 0 0 0 0 0 3 0 0 0 0 0 0 0 0 0 0 0 1
1 0 0 0 0 0 0 3 3 0 0 0 0 3 3 0 0 0 0 3 0 0 0 0 0 0 11 4 4 4 12 0 0 0 0 0 0 3 0 0 0 0 0 0 0 0 0 0 0 1
1 0 0 0 0 0 0 0 3 3 0 0 0 0 3 3 0 0 0 3 3 3 3 3 3 0 7 2 2 15 10 0 0 0 0 0 0 3 3 3 3 3 3 3 3 3 3 0 0 1
1 0 0 0 0 0 0 0 0 3 0 0 0 0 3 3 3 3 3 3 3 3 3 3 0 11 14 2 2 8 0 0 0 0 0 0 0 0 0 0 0 3 3 3 3 3 3 0 0 1
1 0 0 0 0 0 0 3 3 3 3 0 0 0 0 0 0 3 0 0 3 3 3 3 0 7 2 2 2 8 0 0 0 0 0 0 0 0 0 0 0 0 3 3 3 3 3 0 0 1
1 0 0 0 0 0 0 3 0 0 0 3 0 0 0 0 0 3 0 0 3 3 3 3 0 7 2 2 2 8 0 0 0 0 0 0 0 0 0 0 0 0 3 0 0 0 0 0 0 1
1 0 0 0 0 0 3 3 3 3 0 0 0 0 0 0 0 3 0 0 0 0 0 0 0 7 2 2 2 8 0 0 0 0 0 0 0 0 0 0 0 0 3 0 0 0 0 0 0 1
1 0 0 0 0 0 3 3 3 3 0 0 0 0 0 0 0 3 0 0 0 0 0 0 0 7 2 2 15 10 0 0 0 0 0 0 0 0 0 0 0 3 3 0 0 0 0 0 0 1
1 0 0 0 0 0 3 3 3 03 0 0 0 0 0 0 3 3 0 0 0 0 0 0 0 7 2 2 8 0 0 0 0 0 0 0 0 0 0 0 3 3 0 0 0 0 0 0 0 1
1 0 0 0 0 0 0 3 0 0 0 0 0 0 0 0 3 0 0 0 0 0 0 0 11 14 2 2 8 0 0 0 0 0 3 3 3 3 3 3 3 0 0 0 0 0 0 0 0 1
1 0 0 0 0 0 0 3 3 0 0 0 0 0 0 3 3 0 0 0 0 0 0 0 7 2 2 15 10 0 0 0 0 0 3 0 0 0 0 0 3 0 0 0 0 0 0 0 0 1
1 0 0 0 0 0 0 0 3 0 0 0 0 0 0 3 0 0 0 0 0 0 0 0 7 2 2 8 3 3 3 3 0 0 3 0 0 0 0 0 3 0 0 0 0 0 0 0 0 1
1 0 0 0 0 0 0 0 3 0 0 0 0 0 0 3 0 0 0 0 0 0 0 11 14 2 2 8 3 3 3 3 3 3 3 0 0 0 0 0 3 0 0 0 0 0 0 0 0 1
1 0 0 0 0 0 0 0 3 0 0 0 0 0 3 3 0 0 0 0 0 0 0 7 2 2 2 8 3 3 3 3 0 0 0 0 0 0 0 0 3 0 0 0 0 0 0 0 0 1
1 0 0 0 0 0 0 3 3 0 0 0 0 0 3 0 0 0 0 0 0 0 11 14 2 2 2 8 0 0 0 3 0 0 0 0 3 0 3 3 3 0 0 0 0 0 0 0 0 1
1 0 0 0 0 0 0 3 3 0 0 0 0 0 3 0 0 0 0 0 0 0 7 2 2 2 2 8 0 0 0 3 0 0 0 0 3 0 3 3 3 0 0 0 0 0 0 0 0 1
1 0 0 0 0 0 0 0 3 0 0 0 0 0 3 0 0 0 0 0 0 0 9 16 2 2 2 17 12 0 0 3 3 3 3 3 3 0 3 3 3 0 0 0 0 0 0 0 11 1
1 0 0 0 3 3 3 3 3 0 0 0 0 0 3 0 0 0 0 0 0 0 0 7 2 2 2 2 17 12 0 0 0 0 0 0 0 0 3 3 3 0 0 0 0 0 0 11 14 1
1 0 0 0 3 3 0 0 3 3 0 0 0 0 3 3 0 0 0 0 0 0 0 9 16 2 2 2 2 17 12 0 0 0 0 0 0 0 11 4 12 0 0 0 0 0 11 14 2 1
1 0 0 3 3 0 0 0 0 0 0 0 0 0 0 3 0 0 0 0 0 0 0 0 9 16 2 2 2 2 17 12 0 0 0 0 0 11 14 2 17 12 0 0 0 11 14 2 2 1
1 0 0 3 3 0 0 0 0 0 0 0 0 0 0 3 0 0 0 0 0 0 0 0 0 9 16 2 2 2 2 17 4 4 4 4 4 14 2 2 2 17 4 4 4 14 2 2 2 1
1 0 3 3 3 0 0 0 0 0 0 0 0 0 0 3 3 0 0 0 0 0 0 0 0 0 9 16 2 2 2 2 2 2 2 2 2 2 2 2 2 2 2 2 2 2 2 15 10 1
1 0 0 3 3 0 0 0 0 0 0 0 0 0 0 0 3 3 3 0 0 0 0 0 0 0 0 9 16 2 2 2 2 2 2 2 2 2 2 2 2 2 2 2 2 2 15 10 0 1
1 0 0 3 3 0 0 0 0 0 0 0 0 0 0 0 0 0 3 0 0 0 0 0 0 0 0 0 9 16 2 2 2 2 2 2 2 2 15 13 13 2 2 2 15 13 10 0 0 1
1 0 0 0 3 3 0 0 0 0 0 0 0 0 0 0 0 0 3 0 0 0 0 0 0 0 0 0 0 9 16 2 2 2 2 2 2 15 10 0 0 9 13 13 10 0 0 0 0 1
1 0 0 0 0 3 0 0 0 0 0 0 0 0 0 0 0 0 3 0 0 0 0 0 0 0 0 0 0 0 9 13 13 13 13 13 13 10 0 0 0 0 0 0 0 0 0 0 0 1
1 0 0 0 0 3 0 0 0 0 0 0 0 0 0 0 0 3 3 0 0 0 0 0 0 0 0 0 0 0 0 0 0 0 0 0 0 0 0 0 0 0 0 0 0 0 0 0 0 1
1 12 0 0 0 3 3 0 0 0 0 3 3 3 3 0 3 3 3 3 0 0 0 0 0 0 0 0 0 0 0 0 0 0 0 0 0 0 0 0 0 0 0 0 0 0 0 0 0 1
1 17 12 0 0 0 3 3 3 3 0 3 0 0 3 0 3 0 0 3 3 3 3 0 0 0 0 0 0 0 0 0 0 0 0 0 0 0 0 0 0 0 0 0 0 0 0 0 0 1
1 2 17 12 0 0 0 0 0 3 3 3 0 0 3 3 3 0 0 0 0 0 3 3 3 3 3 0 0 0 0 0 0 0 0 0 0 0 0 0 0 0 0 0 0 0 0 0 0 1
1 2 2 2 12 0 0 0 0 0 0 0 0 0 0 0 0 0 0 0 0 0 0 0 0 0 0 0 0 0 0 0 0 0 0 0 0 0 0 0 0 0 0 0 0 0 0 0 0 1
1 2 2 2 17 4 4 4 4 4 12 0 0 0 0 0 0 0 0 0 0 0 0 0 0 0 0 0 0 0 0 0 0 0 0 0 0 0 0 0 0 0 0 0 0 0 0 0 0 1
1 2 2 2 2 2 2 2 2 2 17 12 0 0 0 0 0 0 0 0 0 0 0 0 0 0 0 0 0 0 0 0 0 0 0 0 0 0 0 0 0 0 0 0 0 0 0 0 0 1
1 1 1 1 1 1 1 1 1 1 1 1 1 1 1 1 1 1 1 1 1 1 1 1 1 1 1 1 1 1 1 1 1 1 1 1 1 1 1 1 1 1 1 1 1 1 1 1 1 1
